#######
#A    #
# ### #
#   #B#
#######
